NO tmp_assets/WALL/MWALL3_1.xpm
WE tmp_assets/WALL/MWALL4_1.xpm
SO tmp_assets/WALL/MWALL4_2.xpm
EA tmp_assets/WALL/MWALL5_1.xpm

F 113, 0, 0
C 254,30                    				   											,25

111111111111111111111111111111111111111111111111111111111111111111111111111111111111111
100000000000000000000000000000000000000000000000000000000000000000000000000000000000001
101111111111111111111111100000000000000000000000000000011111111111111111111111111111101
100000000000000000000000100000000000000000000000000000010000000000000000000000000000001
100011111111111100000000111111111000000000111211100000011111111000000000000000000000001
100010000000001000000000000000001000000000100000100000000000001000000000000000000000001
100010000000001000000000000000001000000000100000100000000000001000000000000000000000001
100011112111111000000000000000001111111111100000111111111111111000000000000000000000001
100000000000000000000000000000000000000000200000000000000000000000000000000000000000001
101111111111111111111111111111111111110000100000000000000000000000000000000000000000001
100000000000000000000000000000000000010000100000000000000000000000000000000000000000001
100000000000000000000000000000000000010000100000000000000000000000000000000000000000001
100000000000000000000000000000000000011111111111112111111111000000000000000000000000001
100000000000000000000000000000000000000000000000000000000001000000000000000000000000001
111111111111111111111111111111111111111111100000000000000001000000000000000000000000001
100000000000000000000000000000000000000000100000000000000001000000000000000000000000001
100000000000000000000000000000000000000000100000000000000001000000000000000000000000001
100000000000000000000000000000000000000000100000000000000001000000000000000000000000001
100000000011111111111111111111111111111111100000000000000002000000000000000000000000001
100000000020000000000000000000000000000000000000000000000001000000000000000000000000001
100000000010000000000000000000000000000000000000000000000001000000000000000000000000001
111111111110000000000000000000000000000000000000000000000001000000000000000000000000001
100000000000000000000000000000000000000000000000000000000001000000000000000000000000001
100000000000000000000000000000000000000000000000000000000001000000000000000000000000001
100000000000000000000000000000000000000000000000000000000001000000000000000000000000001
100000000011111111111111111111111111111111111111112111111111000000000000000000000000001
100000000010000000000000000000000000000000000000000000000000000000000000000000000000001
100000000010000000000000000000000000000000000000000000000000000000000000000000000000001
100000000010000000000000000000000000000000000000000000000000000000000000000000000000001
111111111110000000000000000000000000000000000000000000000000000000000000000000000000001
100000000000000000000000000000000000000000000000000000000000000000000000000000000000001
100000000000000000000000000000000000000000000000000000000000000000000000000000000000001
100000000000000000000000000000000000000000000000000000000000000000000000000000000000001
100011111111111111111111111111111111111111111111111111111111111111111111121111111000001
100010000000000000000000000000000000000000000000000000000000000000000000000000000010001
100010000000000000000000000000000000000000000000000000000000000000000000000000000010001
100010000000000000000000000000000000000000000000000000000000000000000000000000000010001
100011111111111111111111111111111111111111211111111111111111111111111111111111111110001
100000000000000000000000000000000000000000000000000000000000000000000000000000000000001
100000000000000000000000000000000000000000000000000000000000000000000000000000000000001
100000000000000000000000000000000000000000000000000000000000000000000000000000000000001
100000000000000000000000000000000000000000N00000000000000000000000000000000000000000001
111111111111111111111111111111111111111111111111111111111111111111111111111111111111111

