NO tmp_assets/WALL/MWALL3_1.xpm
WE tmp_assets/WALL/MWALL4_1.xpm
SO tmp_assets/WALL/MWALL4_2.xpm
EA tmp_assets/WALL/MWALL5_1.xpm

F 113, 0, 0
C 254,30                    				   											,25

		11111111111111111111111111111111111111111111111111111111111111
		1S000000000000000000000000000000000000000000000000000000000001
		10000000000000000000000000000000000000000000000000000000000001
		10000000000000000000000000000000000000000000000000000000000001
		10000000000000000000000000000000000000000000000000000000000001
		10000000000000000000000000000000000000000000000000000000000001
		10000000000000000000000000000000000000000000000000000000000001
		10000000000000000000000000000000000000000000000000000000000001
		10000000000000000000000000000000000000000000000000000000000001
		10000000000000000000000000000000000000000000000000000000000001
		10000000000000000000000000000000000000000000000000000000000001
		10000000000000000000000000000000000000000000000000000000000001
		10000000000000000000000000000000000000000000000000000000000001
		10000000000000000000000000000000000000000000000000000000000001
		10000000000000000000000000000000000000000000000000000000000001
        10000000000000000000000000000000000000000000000000000000000001
		10000000000000000000000000000000000000000000000000000000000001
        10000000000000000000000000000000000000000000000000000000000001
        10000000000000000000000000000000000000000000000000000000000001
        10000000000000000000000000000000000000000000000000000000000001
		10000000000000000000000000000000000000000000000000000000000001
		11111111111111111111111111111111111111111111111111111111111111