NO                         	         ./LE NO    RD.xpm
SO ./LE SUD.xpm
WE ./LE OUEST.xpm
EA ./LE EST.xpm
F 220           ,    100   ,    0 
C 254,30,25

		1111111111111111111111111111111111111
		0000000000001000000000000000000000001 111111111
		0000000000001000000000000000000000001 100000001
		0000000000001000000000000000000000001 100000001
		0000000000001000000000000000000000001 111110111
		0000000000001000000000000000000000001
		00000000000010000000000000000000000011111111
		11111111111110000000000000000000000000000001
		10000000000000000000000000000000000000000001
		10000000000000000000000000000000000011111111
		1000000000000000000000000000000000001
		1000000000000000N00000000000000000001
		1000000000000000000000000000000000001
		1000000000000000000000000000000000001
		1000000000000000000000000000000000001
		1000000000000000000000000000000000001
		1000000000000000000000000000000000001
		1111111111111111111111111111111111111
