NO tmp_assets/WALL/MWALL3_1.xpm
WE tmp_assets/WALL/MWALL4_1.xpm
SO tmp_assets/WALL/MWALL4_2.xpm
EA tmp_assets/WALL/MWALL5_1.xpm

F 113, 0, 0
C 254,30,25

		111111111111111111111111111111111111
		100000000000000000000000010000000000
		100000000000000000000000010000000000 11111111
		100000000000000000000000010000000000 10000001
		100000000000000000000000010000000000 11111111
		100000000000000000000000010000000000
		1000000000000W000000000001111111111111111111
		10000000000000000000000000000000000000000001
		10000000000000000000000000000000000000000001
		10000000000000000000000000000000000011111111
		1000000000000000000000000000000000001
		1000000000000000000000000000000000001
		1000000000000000000000000000000000001
		1000000000000000000000000000000000001
		1000000000000000000000000000000000001
		1000000000000000000000000000000000001
		1000000000000000000000000000000000001
		1111111111111111111111111111111111111