NO tmp_assets/WALL/MWALL3_1.xpm
WE tmp_assets/WALL/MWALL4_1.xpm
SO tmp_assets/WALL/MWALL4_2.xpm
EA tmp_assets/WALL/MWALL5_1.xpm

F 113, 0, 0
C 254,30                    				   											,25

		1111111111111111111111111111111111111
		1000000000001000000000000000000000001				
		1000000000001000011111000000000000001
		1000000000001000100001000000000000001
1111111111110000000000001000100001111110000011111111111111111111111111111
10000000000000000000001000100000000020000000001
11111111111100000000000012001111111110100000000111
		111111111111100000000000101000000000000001
		10000000S000000000000000101111000000000001
		100000000000000000000000100000000111111111
		1000000000000000000000001111110001
		1000000000000000000000010000010001
		10000120000200000000000200000200001
		10000000000100000000000010000010001
		10000010000000001111111010000010001
		10000020002100001000001011111110001
		10000000000000001111111000000000001
		11111111111111111111111111111111111