NO ./LE /tmp_assets/MWALL3_1.xpm
WE ./LE /tmp_assets/MWALL4_1.xpm
SO ./LE /tmp_assets/MWALL4_2.xpm
EA ./LE /tmp_assets/MWALL5_1.xpm

F 220, 100, 10 
C 254,30                    				   											,25

		1111111111111111111111111111111111111
		1000000000001000000000000000000000001				
		1000000000001000011111000000000000001
		1000000000001000100001000000000000001
1111111111110000000000001000100001111110000011111111111111111111111111111
10000000000000000000001000100000000010000000001
11111111111100000000000010001111111110100000000111
		111111111111100000000000101000000000000001
		100000000000000000000000000101111000000001
		100000000000000000000000100000000111111111
		1000000000000000000000001111110001
		1000000000000000N00000010000010001
		10000000000000000000000000000000001
		10000000000000000000000010000010001
		10000000000000001111111010000010001
		10000000000000001000001011111110001
		10000000000000001111111000000000001
		11111111111111111111111111111111111