NO ./LE NORD.xpm
WE ./LE OUEST.xpm
SO ./LE SUD.xpm
EA ./LE EST.xpm

F 220,100,0
C 225,30,0

		11111111111111111111111111
		100000000000000000000000010000000000
		100000000000000000000000010000000000 11111111
		100000000000000000000000010000000000 10000001
		100000000000000000000000010000000000 11111111
		100000000000000000000000010000000000
		10000000000000000000000001111111111111111111
		10000000000000000000000000000000000000000001
		10000000000000000000000000000000000000000001
		10000000000000000000000000000000000011111111
		1000000000000000000000000000000000001
		1000000000000000000000000000000000001
		1000000000000000000000000000000000001
		1000000000000000000000000000000000001
		1000000000000000000000000000000000001
		1000000000000000000000000000000000001
		1000000000000000000000000000000000001
		1111111111111111111111111111111111111